###################
#O          ##G ###
##    ########  ###
##              ######
##G   ######     G  k#
############   #####S#
#####G    A    SSSSSS#
########x#### ########
##########    ##
##########    ##
##########   G##
##            ##
##  #######S########
##                k#
##  G       ########
##        G ####
##          ####
################